################
#E E EE E EEE E#
#              #
################
#   P          #
#              #
# K            DW
################