###############
#    E        #
#             #
#             #
#            KDW
# P           #
#             #
#             #
#             #
#    E        #
###############