 ###############
 #      #  K   #
 #      #      #
 # P    #      #
WD      H      #
 #      #      #
 ###############